3 3 3 3 3 3 3 3 3
3 1 3 0 0 0 3 1 3
3 3 2 3 0 3 2 3 3
0 2 3 3 3 3 3 2 0
1 1 1 1 1 1 1 1 1